1939	Information\Arts & Humanities	Information\Law & Politics	Living\Finance & Investment	Information\Education	
0 apr	Living\Finance & Investment	Information\Companies & Industries	Shopping\Buying Guides & Researching		
1099 form	Living\Finance & Investment	Computers\Software	Information\Law & Politics	Computers\Internet & Intranet	Information\References & Libraries
1967 impala	Living\Car & Garage	Sports\Auto Racing			
a worn path critique	Information\Arts & Humanities	Living\Book & Magazine	Information\References & Libraries		
aatfcu	Information\Companies & Industries	Living\Finance & Investment	Shopping\Stores & Products		
aberdeen police department	Information\Local & Regional 	Information\Law & Politics			
accountancy jobs	Living\Career & Jobs	Information\Companies & Industries	Living\Finance & Investment		
address for clallam county sheriff	Information\Local & Regional 	Information\Law & Politics			
adelphia power page	Computers\Internet & Intranet	Online Community\Homepages			
adidas campus	Living\Fashion & Apparel	Living\Health & Fitness	Shopping\Stores & Products	Shopping\Bargains & Discounts	
aerial advertising	Information\Companies & Industries	Living\Career & Jobs	Shopping\Stores & Products		
Aerosols	Information\Science & Technology	Information\References & Libraries			
affiliateprograms	Information\Companies & Industries	Living\Career & Jobs			
african capitals	Information\Local & Regional 	Information\References & Libraries			
aircargo tracking	Shopping\Other				
airline carryon restrictions	Living\Travel & Vacation	Information\Other			
airline reservations	Living\Travel & Vacation	Shopping\Other			
alcoholic recipes	Living\Food & Cooking	Living\Other			
all music	Entertainment\Music				
allan iverson	Sports\Basketball	Shopping\Auctions & Bids	Entertainment\Games & Toys		
alpena high school	Information\Local & Regional 	Information\Education			
american candle factory	Shopping\Stores & Products	Shopping\Auctions & Bids	Living\Furnishing & Houseware		
american express company	Information\Companies & Industries				
american girl	Living\Book & Magazine	Entertainment\Games & Toys	Living\Gifts & Collectables		
amerisuites	Living\Travel & Vacation	Information\Companies & Industries			
amniocentisis	Living\Health & Fitness	Information\Science & Technology			
animated movies	Entertainment\Movies	Information\References & Libraries			
anne klein watches	Living\Gifts & Collectables	Living\Fashion & Apparel	Shopping\Stores & Products		
anniversary ring	Living\Gifts & Collectables	Shopping\Stores & Products	Shopping\Buying Guides & Researching		
annuity loans	Living\Finance & Investment	Information\References & Libraries	Information\Companies & Industries	Shopping\Stores & Products	
apha	Living\Health & Fitness	Information\References & Libraries			
applause	Entertainment\Other	Information\References & Libraries			
application servers	Computers\Software	Computers\Other	Information\Companies & Industries		
appraiser forum	Online Community\Forums & Groups				
aquarium	Entertainment\Other	Living\Furnishing & Houseware	Living\Pets & Animals	Shopping\Buying Guides & Researching	
arabic poems	Information\Arts & Humanities	Information\References & Libraries			
architecture competition	Information\Arts & Humanities	Information\References & Libraries			
arizona bar exam	Information\Law & Politics	Information\References & Libraries	Information\Local & Regional 		
arthritis pain	Living\Health & Fitness	Information\References & Libraries			
arthur tress	Information\Arts & Humanities	Entertainment\Other			
articles of incorperation;washington	Information\Local & Regional 	Information\References & Libraries	Information\Law & Politics		
artistic greetings	Information\Arts & Humanities	Living\Gifts & Collectables	Shopping\Stores & Products		
ashley furniture outlet	Living\Furnishing & Houseware	Shopping\Stores & Products			
asia pacific	Information\Local & Regional 	Information\References & Libraries	Living\Travel & Vacation		
asking for a raise	Living\Career & Jobs				
askjevies	Computers\Internet & Intranet	Online Community\Homepages			
ata hotels in italy	Information\Local & Regional 	Living\Travel & Vacation	Shopping\Other		
athlon xp	Computers\Hardware	Computers\Other	Computers\Mobile Computing		
atv trails	Sports\Outdoor Recreations	Sports\Other			
aubergine	Information\Local & Regional 	Living\Food & Cooking			
austin realtors	Information\Local & Regional 	Living\Real Estate			
australian law foundation	Information\Local & Regional 	Information\Law & Politics			
auto blue book prices	Living\Car & Garage	Shopping\Bargains & Discounts			
automotive lights	Living\Car & Garage	Shopping\Stores & Products			
autos under $200.00	Shopping\Bargains & Discounts	Living\Car & Garage			
avecia	Information\Companies & Industries	Information\References & Libraries	Information\Science & Technology		
azcentral	Living\Book & Magazine	Online Community\Homepages	Computers\Internet & Intranet		
baby arab songs	Entertainment\Music	Living\Family & Kids			
babylonian numbers	Information\References & Libraries	Information\Education			
baker's rack	Living\Furnishing & Houseware	Living\Food & Cooking	Shopping\Stores & Products		
balmorhea blue agate	Information\Science & Technology	Living\Gifts & Collectables	Shopping\Stores & Products		
baltimore ravens	Sports\American Football	Sports\Schedules & Tickets	Sports\News & Scores		
bankruptcy fraud	Living\Finance & Investment	Information\Companies & Industries			
bar accessories	Living\Furnishing & Houseware				
barnyard animals	Living\Pets & Animals	Entertainment\Other			
barnyard pictures	Entertainment\Pictures & Photos	Information\References & Libraries	Living\Landscaping & Gardening		
barstool	Living\Furnishing & Houseware	Shopping\Stores & Products			
basic basketball skills	Sports\Basketball				
bass sandals	Living\Fashion & Apparel	Shopping\Stores & Products			
bateries or for or cell or phones	Computers\Mobile Computing	Shopping\Other	Living\Tools & Hardware		
baylor hospital irving	Living\Health & Fitness	Information\Local & Regional 	Living\Gifts & Collectables		
beacon federal	Living\Finance & Investment	Information\Companies & Industries			
beaver collectibles	Living\Gifts & Collectables	Living\Pets & Animals			
beckhoff	Computers\Hardware	Computers\Software	Information\Companies & Industries	Shopping\Stores & Products	
bedroom idea master	Living\Furnishing & Houseware	Living\Health & Fitness	Living\Real Estate	Shopping\Buying Guides & Researching	
best water treatment	Living\Health & Fitness	Information\Other	Living\Landscaping & Gardening		
bicycle rides party	Sports\Outdoor Recreations	Living\Health & Fitness			
biography beatrix potter	Information\Arts & Humanities	Information\References & Libraries	Living\Family & Kids		
bird of paradise flower	Living\Landscaping & Gardening	Living\Gifts & Collectables	Information\References & Libraries		
birthdaysandangels	Living\Family & Kids	Entertainment\Other			
black art	Information\Arts & Humanities	Information\References & Libraries	Living\Gifts & Collectables	Shopping\Buying Guides & Researching	
black boy	Information\Arts & Humanities	Living\Book & Magazine	Information\Law & Politics		
black history month this week	Information\References & Libraries	Information\Arts & Humanities	Information\Law & Politics		
black monday	Entertainment\Games & Toys	Living\Finance & Investment	Information\Companies & Industries	Living\Fashion & Apparel	
bladder cancer symptoms	Living\Health & Fitness	Information\Science & Technology	Information\References & Libraries	Information\Education	
blood work	Living\Health & Fitness	Information\Education	Living\Career & Jobs	Information\Local & Regional 	
bob moore auto	Shopping\Stores & Products	Living\Car & Garage			
bodega bay sportfishing	Sports\Outdoor Recreations	Information\Local & Regional 	Living\Pets & Animals	Living\Travel & Vacation	
bolt-on rollcages	Living\Car & Garage	Living\Tools & Hardware	Shopping\Stores & Products		
bon ton	Shopping\Stores & Products	Information\Local & Regional 			
book storage and preservation	Information\References & Libraries	Information\Education	Living\Book & Magazine		
boostmobile	Computers\Mobile Computing	Shopping\Bargains & Discounts			
boreal ski	Information\Local & Regional 	Sports\Outdoor Recreations			
boss pedals	Shopping\Stores & Products	Computers\Hardware	Entertainment\Other		
boston colleges	Information\Education	Information\Local & Regional 			
boston es lens	Information\Local & Regional 	Shopping\Stores & Products	Entertainment\Pictures & Photos		
bourbon reforms	Information\Local & Regional 	Information\Law & Politics	Information\References & Libraries		
bra size	Living\Fashion & Apparel	Information\Other	Shopping\Buying Guides & Researching		
brainpop electricity	Information\Education	Information\References & Libraries			
brand management	Living\Career & Jobs	Information\Arts & Humanities	Information\Companies & Industries	Information\References & Libraries	
breeding hourse and raising	Living\Pets & Animals	Information\References & Libraries	Information\Education		
brian lumley	Living\Book & Magazine	Entertainment\Humor & Fun	Information\Arts & Humanities		
broadband internet	Computers\Internet & Intranet	Online Community\Other			
brokerage houses	Living\Finance & Investment				
brooks	Living\Fashion & Apparel	Shopping\Stores & Products			
broyhill computer armoire	Living\Furnishing & Houseware	Computers\Other			
brush cutters	Living\Furnishing & Houseware	Living\Landscaping & Gardening			
bua chompoo	Entertainment\Other				
bullmastiff photos	Living\Pets & Animals	Entertainment\Pictures & Photos			
bumble bee halloween costumes	Living\Family & Kids	Living\Fashion & Apparel	Entertainment\Games & Toys	Entertainment\Other	Shopping\Stores & Products
burberry brit	Living\Gifts & Collectables	Shopping\Stores & Products			
cacapon resort west virginia	Living\Travel & Vacation	Information\Local & Regional 			
cag conference sacramento	Information\Local & Regional 				
cal state northridge	Sports\Baseball	Online Community\Homepages			
camouflage face paint	Entertainment\Other				
Campbell Scott	Entertainment\Music	Entertainment\TV	Entertainment\Other		
camper trailers	Sports\Outdoor Recreations	Living\Travel & Vacation			
cancell	Information\Companies & Industries	Information\References & Libraries	Information\Science & Technology	Living\Health & Fitness	
cancer of the eye	Living\Health & Fitness	Information\Education	Information\Science & Technology	Information\References & Libraries	
canton ohio old pewter plate	Living\Gifts & Collectables	Shopping\Auctions & Bids			
cappucino	Living\Food & Cooking	Shopping\Other			
car auction in flat rock michigan	Shopping\Auctions & Bids	Information\Local & Regional 	Living\Car & Garage		
car loans with bad credit	Living\Finance & Investment	Living\Car & Garage			
car seat laws	Information\Law & Politics	Living\Car & Garage			
car spy pics	Living\Car & Garage				
caranddriver	Living\Car & Garage	Living\Book & Magazine	Shopping\Buying Guides & Researching		
cardinal strich	Information\Education	Information\Local & Regional 			
career as a teacher	Living\Career & Jobs	Information\Education			
careercrusing	Living\Career & Jobs	Living\Travel & Vacation			
carmen marc valvo	Living\Fashion & Apparel	Entertainment\Celebrities	Shopping\Stores & Products		
carpet shampoo	Living\Furnishing & Houseware	Living\Pets & Animals	Shopping\Stores & Products	Shopping\Buying Guides & Researching	Living\Real Estate
carpet stains	Living\Furnishing & Houseware	Living\Pets & Animals	Shopping\Stores & Products	Shopping\Buying Guides & Researching	Living\Real Estate
casino blackjack	Entertainment\Games & Toys	Entertainment\Other	Information\Other	Living\Other	
casio keyboard	Entertainment\Music	Living\Furnishing & Houseware	Computers\Hardware	Information\Arts & Humanities	
castles	Information\Arts & Humanities	Information\References & Libraries	Entertainment\Other	Living\Gifts & Collectables	Living\Real Estate
cat claw decals	Shopping\Stores & Products				
catholic charities lasvegas	Living\Religion & Belief	Information\Local & Regional 			
catwalk hair	Living\Other	Entertainment\Other			
cecil county schools	Information\Local & Regional 	Information\Education			
celebrity	Entertainment\Celebrities	Entertainment\Movies	Entertainment\Music	Entertainment\Pictures & Photos	Entertainment\TV
cellphone service	Computers\Mobile Computing	Shopping\Stores & Products	Living\Tools & Hardware		
cerritos college	Information\Education	Information\Local & Regional 			
chain maille	Information\References & Libraries	Living\Fashion & Apparel	Entertainment\Other	Living\Gifts & Collectables	
chalks airlines	Living\Travel & Vacation	Shopping\Bargains & Discounts			
champagne punch recipes	Living\Food & Cooking				
chase mortgage company	Living\Finance & Investment	Information\Companies & Industries			
cheap international airfare	Living\Travel & Vacation	Shopping\Bargains & Discounts			
check credit	Living\Finance & Investment				
cheese puffs	Living\Food & Cooking	Entertainment\Other			
chemical processing of hair	Entertainment\Other	Living\Other	Information\References & Libraries		
chevy luv	Living\Car & Garage				
chicago tribune	Information\Local & Regional 	Living\Book & Magazine	Online Community\Homepages		
chicken recipe websites	Computers\Internet & Intranet	Living\Food & Cooking			
childrens encyclopedia	Information\Education	Information\References & Libraries	Living\Book & Magazine		
childrens musuem of minnesota	Information\Local & Regional 	Living\Family & Kids	Entertainment\Other		
china shanghai hotel	Information\Local & Regional 	Living\Travel & Vacation	Shopping\Stores & Products		
christoper china collection	Living\Gifts & Collectables	Living\Furnishing & Houseware			
christopher lowell collection	Living\Furnishing & Houseware	Living\Gifts & Collectables			
chuck klosterman	Information\Local & Regional 	Living\Book & Magazine			
cigar wholesale	Entertainment\Other	Living\Other	Shopping\Bargains & Discounts		
cincinnati bikers	Information\Local & Regional 	Sports\Outdoor Recreations			
civil war	Information\Arts & Humanities	Information\References & Libraries			
claimspro	Information\Companies & Industries	Living\Health & Fitness			
classified room hold down clips	Living\Other				
classroom accountability system	Information\Education				
claudia mills	Information\Arts & Humanities	Living\Book & Magazine	Online Community\People Search		
clay aiken web sites	Entertainment\Music	Online Community\People Search	Entertainment\Celebrities		
clay poker chip	Entertainment\Games & Toys	Shopping\Stores & Products			
clean imesh	Computers\Multimedia	Computers\Software	Entertainment\Music		
CLERKS	Entertainment\Movies	Entertainment\Celebrities	Shopping\Stores & Products		
cnnasia	Entertainment\TV	Information\Local & Regional 			
coach factory outlet	Living\Fashion & Apparel	Shopping\Bargains & Discounts			
coeurdalene	Information\Local & Regional 	Sports\Outdoor Recreations	Living\Travel & Vacation		
colgate university	Information\Education				
college fight songs	Entertainment\Other	Sports\Other			
college search	Information\Education	Information\References & Libraries			
coloured contact lens	Living\Health & Fitness	Shopping\Stores & Products			
colouring donald duck page	Living\Family & Kids	Entertainment\Humor & Fun	Entertainment\Games & Toys		
columbia missourian birth announcements	Information\Local & Regional 	Living\Other			
columbia sandals	Living\Fashion & Apparel	Shopping\Stores & Products			
combat instinct3	Entertainment\Games & Toys	Computers\Multimedia			
comfot inn	Living\Travel & Vacation	Information\Companies & Industries	Shopping\Stores & Products		
comic images	Entertainment\Pictures & Photos	Entertainment\Humor & Fun			
commercial mortgage lender	Living\Finance & Investment	Information\Companies & Industries	Living\Real Estate		
composition poses a problem for literature	Information\Education	Information\Arts & Humanities			
computer dictionary	Computers\Software	Living\Book & Magazine	Information\References & Libraries		
consulting companies	Information\Companies & Industries	Living\Career & Jobs			
consumer credit counseling	Living\Finance & Investment	Information\Companies & Industries			
contactlens	Living\Health & Fitness	Shopping\Stores & Products			
contra roms	Entertainment\Games & Toys	Shopping\Stores & Products			
converting a 1972 beetle sedan into a convertible	Living\Car & Garage	Living\Tools & Hardware			
cooking supplies	Living\Food & Cooking	Living\Tools & Hardware			
copier repair	Computers\Hardware	Living\Tools & Hardware			
coquitlam centre	Information\Local & Regional 				
costa rica information	Living\Travel & Vacation	Information\Local & Regional 			
costarica	Living\Travel & Vacation	Information\Local & Regional 			
country music movies	Entertainment\Movies	Entertainment\Music			
cowan realtors	Living\Real Estate	Information\Companies & Industries			
credit reporting services	Living\Finance & Investment	Information\Companies & Industries	Shopping\Stores & Products		
crockpot recipe	Living\Food & Cooking				
cross pendant	Information\Companies & Industries	Shopping\Stores & Products	Living\Gifts & Collectables	Living\Religion & Belief	
cross stitch angels	Information\Companies & Industries	Shopping\Stores & Products	Living\Gifts & Collectables	Living\Religion & Belief	
cruise value	Living\Travel & Vacation	Shopping\Bargains & Discounts	Shopping\Buying Guides & Researching		
cumberland times newspaper	Information\Local & Regional 	Online Community\Homepages			
curling irons	Living\Tools & Hardware	Sports\Other			
custom mail boxes	Computers\Internet & Intranet	Information\Science & Technology	Computers\Networks & Telecommunication	Living\Tools & Hardware	
d'addario strings	Entertainment\Music				
dail up connetion	Computers\Internet & Intranet	Computers\Networks & Telecommunication	Information\Science & Technology		
david blaine	Entertainment\Celebrities	Entertainment\Other	Entertainment\Games & Toys		
day after day	Entertainment\Music	Information\Arts & Humanities	Shopping\Other		
DAYLIGHT	Living\Health & Fitness	Living\Family & Kids	Information\Science & Technology	Living\Travel & Vacation	Living\Other
dead to rights guide	Entertainment\Games & Toys	Entertainment\Movies			
deaf dogs	Living\Pets & Animals	Information\References & Libraries			
debt consolidate	Living\Finance & Investment	Information\Companies & Industries	Shopping\Stores & Products		
default credit card debt	Living\Finance & Investment	Information\Companies & Industries	Shopping\Stores & Products		
Dennis Christopher	Entertainment\Celebrities				
derrek lee	Sports\Baseball				
devil costume accessories	Shopping\Stores & Products	Entertainment\Games & Toys			
dianne mcguiness	Information\Other	Living\Book & Magazine			
diaphragmatic breathing	Living\Health & Fitness	Sports\Other			
diet calculator	Information\Science & Technology	Living\Health & Fitness			
dingking	Living\Tools & Hardware	Information\Companies & Industries	Shopping\Stores & Products		
dirt devil vacuum	Living\Furnishing & Houseware	Shopping\Stores & Products			
discount bmw parts	Living\Car & Garage	Shopping\Bargains & Discounts			
divinity candy	Living\Food & Cooking				
dog jokes	Entertainment\Humor & Fun				
doll knitting	Entertainment\Games & Toys	Living\Family & Kids			
dollz maker	Entertainment\Games & Toys	Living\Family & Kids			
dollz pic	Entertainment\Games & Toys	Living\Family & Kids			
dough ornaments	Living\Food & Cooking				
dover elevator	Information\Companies & Industries				
download directx	Computers\Software	Computers\Internet & Intranet			
drew shoes	Living\Fashion & Apparel	Shopping\Stores & Products			
drug guide	Living\Health & Fitness	Information\References & Libraries	Shopping\Buying Guides & Researching		
ducati motorcycle	Living\Car & Garage	Shopping\Stores & Products			
dvd label searcher	Shopping\Stores & Products	Computers\Internet & Intranet	Entertainment\Movies		
e scooter	Living\Other				
ear plug	Living\Health & Fitness				
early simptons of hiv	Information\Science & Technology	Living\Health & Fitness	Information\References & Libraries		
east texas real estate	Living\Real Estate	Information\Local & Regional 			
eastmountainsouth lyrics	Entertainment\Music				
eaton aeroquip	Information\Companies & Industries				
ebay costumes	Shopping\Stores & Products	Shopping\Auctions & Bids			
eddie b	Information\Companies & Industries	Living\Fashion & Apparel	Shopping\Stores & Products		
edina schools	Information\Education	Information\Local & Regional 			
egyptains	Information\Local & Regional 	Information\References & Libraries	Information\Law & Politics		
el tovar hotel	Living\Travel & Vacation				
electric log splitters	Living\Tools & Hardware				
elementary education	Information\Education				
elen feinberg	Information\Law & Politics				
elf pics	Entertainment\Pictures & Photos				
elijah house	Online Community\Homepages				
emerica skate	Sports\Outdoor Recreations	Shopping\Stores & Products	Information\Local & Regional 		
entertainment hollywood california feb 2005	Entertainment\Other	Information\Local & Regional 			
environmentally friendly darkroom chemicals\	Entertainment\Pictures & Photos	Living\Tools & Hardware			
epiglottitis	Information\Science & Technology				
ernie ball	Entertainment\Music	Shopping\Other			
espn picks	Entertainment\TV	Sports\Other			
espnlive	Entertainment\TV	Computers\Internet & Intranet	Sports\Other		
eu members	Information\Law & Politics				
eukanuba dog food	Living\Pets & Animals	Shopping\Stores & Products			
exersaucer	Living\Family & Kids	Entertainment\Games & Toys	Information\Companies & Industries	Shopping\Stores & Products	
eye bags	Living\Health & Fitness				
family circle	Living\Book & Magazine	Entertainment\Humor & Fun			
familytrust	Information\Companies & Industries	Living\Finance & Investment			
famous people costumes	Living\Fashion & Apparel	Entertainment\Celebrities	Entertainment\Humor & Fun		
famous volcanoes	Information\Other	Information\References & Libraries			
fantasy games	Entertainment\Games & Toys	Computers\Internet & Intranet			
farside gallery	Living\Book & Magazine	Entertainment\Humor & Fun			
fastenable plastic containers	Living\Tools & Hardware	Shopping\Stores & Products			
father daughter	Living\Family & Kids				
ferrari spyder	Living\Car & Garage				
fertility calender	Living\Health & Fitness				
file local taxes in harrisburg pa	Living\Finance & Investment	Information\Law & Politics	Information\Local & Regional 		
file taxes on line	Living\Finance & Investment	Computers\Internet & Intranet	Information\Law & Politics		
final fantasy tactics jobs	Living\Career & Jobs				
findagrave	Living\Family & Kids	Computers\Internet & Intranet	Information\Local & Regional 		
finger eleven	Entertainment\Music				
Finola Hughes	Entertainment\Celebrities				
first americans	Information\Arts & Humanities	Information\References & Libraries			
fleetwood rv	Living\Car & Garage				
florida athletics	Sports\Other	Information\Local & Regional 			
florida corporation	Information\Local & Regional 	Information\Companies & Industries			
food network .com/tv	Entertainment\TV	Computers\Internet & Intranet			
foodwebs	Information\Science & Technology	Information\References & Libraries			
ford ranger forums	Online Community\Forums & Groups	Living\Car & Garage			
forever and always	Information\Companies & Industries	Entertainment\Games & Toys			
formal evening dresses	Shopping\Stores & Products	Living\Fashion & Apparel			
forum avatars	Online Community\Forums & Groups	Entertainment\Pictures & Photos			
frame oval picture	Entertainment\Pictures & Photos	Living\Gifts & Collectables			
franklin county recorder	Information\Law & Politics	Information\Local & Regional 	Living\Real Estate		
frannet	Information\Companies & Industries	Computers\Internet & Intranet	Online Community\Forums & Groups		
freddy crougar	Information\Other				
free christian chat	Online Community\Chat & Instant Messaging	Living\Religion & Belief			
free clip arts	Information\Arts & Humanities	Entertainment\Pictures & Photos	Computers\Software	Computers\Other	
free cursive fonts	Computers\Software				
free cute baby photo contests	Living\Family & Kids	Entertainment\Pictures & Photos			
free full 3d massively multiplayer online game downloads	Computers\Multimedia	Computers\Internet & Intranet	Computers\Software	Entertainment\Games & Toys	
free game whomp word	Entertainment\Games & Toys	Computers\Software			
free nextel ringtone	Entertainment\Music	Information\Arts & Humanities	Computers\Mobile Computing		
free payroll software	Computers\Software	Living\Finance & Investment			
free samples for teens	Shopping\Bargains & Discounts	Living\Family & Kids			
free scrapbooking pages	Computers\Multimedia	Entertainment\Pictures & Photos	Living\Tools & Hardware		
free speed booster	Computers\Networks & Telecommunication	Computers\Software			
free stuff for your website	Computers\Internet & Intranet				
freezing vegetables	Living\Food & Cooking				
friends scripts	Entertainment\TV				
frontier community college; il	Information\Education	Information\References & Libraries			
full metal jacket pics	Entertainment\Movies	Entertainment\Pictures & Photos			
funnies	Entertainment\Humor & Fun				
g.w. bush's cabnete	Information\Law & Politics				
garbage	Entertainment\Music	Living\Furnishing & Houseware			
garrett college	Information\Education	Living\Family & Kids	Information\Local & Regional 		
gastritis	Living\Health & Fitness	Information\Science & Technology			
gemtek	Living\Furnishing & Houseware	Living\Landscaping & Gardening	Living\Real Estate		
gerontological nursing	Information\Science & Technology	Information\Education	Living\Health & Fitness		
gigabyte motherboard	Computers\Hardware	Information\Science & Technology	Shopping\Stores & Products		
gilda texter	Entertainment\Movies				
gladiator soundtrack	Entertainment\Movies	Entertainment\Other	Shopping\Stores & Products		
glencoe	Information\Education				
gmac auto loan	Living\Finance & Investment	Living\Car & Garage			
gocarts	Sports\Auto Racing	Living\Car & Garage			
godsmack concert tickets	Shopping\Buying Guides & Researching	Entertainment\Music			
gohan and videl	Entertainment\Games & Toys	Entertainment\Pictures & Photos	Information\Arts & Humanities	Living\Family & Kids	
gold chains	Shopping\Stores & Products	Living\Fashion & Apparel			
gold shield	Living\Health & Fitness	Living\Car & Garage			
golden shrimp recipe at tsukasa	Living\Food & Cooking	Information\Local & Regional 			
golf ball testing	Sports\Outdoor Recreations	Shopping\Other			
golf discount store	Shopping\Bargains & Discounts	Sports\Outdoor Recreations			
golf glen movie theatre illinois	Information\Local & Regional 	Entertainment\Movies			
goverment programs	Information\Law & Politics				
grand hyatt washington dc	Information\Local & Regional 	Living\Travel & Vacation			
grandaddy lyrics	Entertainment\Music	Information\Arts & Humanities	Living\Family & Kids		
great lakes aviation	Sports\Outdoor Recreations	Information\Local & Regional 			
green tomato mincemeat	Living\Food & Cooking				
greyhoundlines	Information\Local & Regional 	Living\Travel & Vacation			
guru rinpoche practice	Living\Religion & Belief				
habbo hotel cheats	Entertainment\Games & Toys	Computers\Software	Computers\Security		
halloween pirate costume	Living\Fashion & Apparel	Living\Family & Kids	Shopping\Stores & Products		
hand made bird feeder	Shopping\Stores & Products	Living\Tools & Hardware			
healthaccess	Living\Health & Fitness	Information\Local & Regional 			
heartache	Living\Health & Fitness	Information\Science & Technology			
heartburn	Living\Health & Fitness	Information\Science & Technology	Information\References & Libraries		
heelys	Shopping\Stores & Products	Living\Fashion & Apparel			
hilton maldives	Living\Travel & Vacation				
hip clothing	Living\Fashion & Apparel				
history of jerusalem	Information\Arts & Humanities	Information\Law & Politics	Information\Local & Regional 	Information\References & Libraries	
hms capitol	Living\Real Estate	Living\Finance & Investment			
holes movie	Entertainment\Movies	Information\Arts & Humanities			
home brewing kit	Living\Food & Cooking	Living\Tools & Hardware			
home gym equipment	Living\Health & Fitness	Living\Tools & Hardware			
home office phone system	Living\Tools & Hardware	Computers\Networks & Telecommunication	Computers\Multimedia		
home theater equipment	Living\Tools & Hardware	Living\Furnishing & Houseware	Computers\Multimedia		
homes for sale in atlanta ga	Living\Real Estate	Information\Local & Regional 			
honda cd player	Living\Car & Garage	Entertainment\Music	Computers\Hardware		
honda elsinore	Living\Car & Garage	Information\Companies & Industries	Shopping\Stores & Products		
hope publishing	Entertainment\Music	Information\Arts & Humanities			
house for sale in florida	Living\Real Estate	Information\Local & Regional 			
how to get out of debt	Living\Finance & Investment				
how to play cricket	Entertainment\Games & Toys	Sports\Other			
hunting knifes	Living\Tools & Hardware	Sports\Outdoor Recreations			
hutchinson public library	Information\Arts & Humanities	Information\Local & Regional 			
idocket support	Information\Law & Politics	Computers\Internet & Intranet	Online Community\Forums & Groups	Information\Companies & Industries	
incorporating in texas	Information\Law & Politics	Information\Local & Regional 	Information\Companies & Industries		
incumbent	Information\Law & Politics				
indianrail	Information\Local & Regional 				
insurance careers	Living\Career & Jobs				
insurance policy	Information\Arts & Humanities	Living\Finance & Investment			
internet explorer	Computers\Internet & Intranet	Computers\Software			
intrinsic	Computers\Multimedia	Information\Companies & Industries	Information\Science & Technology	Information\Arts & Humanities	
irish food recipes	Living\Food & Cooking	Information\Local & Regional 			
iroc wheels	Living\Car & Garage	Living\Tools & Hardware			
is ron howard in the movie	Entertainment\Movies	Entertainment\Celebrities			
islamic greetings	Information\Arts & Humanities	Information\Law & Politics	Information\Local & Regional 		
iwon fantasy hockey	Entertainment\Games & Toys	Sports\Other			
jacket patches	Living\Fashion & Apparel				
janet wojcik	Sports\Other				
jann arden	Entertainment\Celebrities	Entertainment\Movies			
jasons deli	Living\Food & Cooking	Information\Local & Regional 			
jeep floor mats	Living\Car & Garage				
jeep stroller	Living\Car & Garage				
jeffrey and thompson	Information\Law & Politics	Information\Science & Technology			
jennifer finnigan	Entertainment\Celebrities	Entertainment\Movies			
jerry oliver	Entertainment\Celebrities	Entertainment\Music			
jerry thompson	Information\Science & Technology	Information\Companies & Industries	Information\Local & Regional 	Living\Real Estate	
jessica mcclintock dress	Shopping\Stores & Products	Living\Fashion & Apparel	Information\Arts & Humanities		
jewelry armoire	Shopping\Stores & Products	Shopping\Bargains & Discounts	Information\Arts & Humanities		
jobs in uae	Living\Career & Jobs	Information\Local & Regional 			
john wooden	Entertainment\Celebrities	Sports\Basketball	Information\Arts & Humanities	Living\Book & Magazine	
jokes funny stories	Entertainment\Humor & Fun				
journal of the san juans	Living\Book & Magazine	Information\Local & Regional 	Entertainment\Other	Computers\Internet & Intranet	Information\Science & Technology
JUMANJI	Entertainment\Movies	Living\Book & Magazine	Entertainment\TV	Shopping\Stores & Products	
kate spade handbags	Living\Fashion & Apparel	Shopping\Stores & Products	Information\Companies & Industries		
kathi livornese	Online Community\People Search				
keegan connor tracy	Entertainment\Celebrities	Entertainment\Movies			
kellybluebookusedcarvalues	Living\Car & Garage	Shopping\Bargains & Discounts	Information\Companies & Industries		
Kids Halloween Costume	Living\Fashion & Apparel	Living\Family & Kids	Shopping\Stores & Products		
kimbanet	Online Community\Forums & Groups	Online Community\Homepages	Information\Local & Regional 		
kimber guns	Shopping\Stores & Products	Sports\Other	Living\Tools & Hardware		
kitchen cabinet handles	Living\Tools & Hardware	Living\Furnishing & Houseware	Shopping\Stores & Products		
knickerbocker hotel	Living\Travel & Vacation	Information\Local & Regional 			
knoxville real estate	Living\Real Estate	Information\Local & Regional 			
korean song lyrics	Entertainment\Music	Information\Local & Regional 			
korg d1600	Computers\Multimedia	Living\Furnishing & Houseware	Entertainment\Music	Information\Science & Technology	Information\Companies & Industries
la county museum	Living\Travel & Vacation	Information\Arts & Humanities	Information\Local & Regional 		
lady baltimore cake	Living\Food & Cooking	Information\Arts & Humanities			
lah real estate	Living\Real Estate				
lancia scorpion	Living\Car & Garage	Information\Companies & Industries			
langston hughes	Online Community\People Search	Information\Arts & Humanities	Information\Education	Information\Law & Politics	
larkin center	Information\Science & Technology	Information\Companies & Industries	Information\Education		
larryboy	Entertainment\Games & Toys	Living\Family & Kids			
laryngitis	Living\Health & Fitness	Information\Science & Technology			
latex halloween masks	Living\Furnishing & Houseware	Living\Gifts & Collectables			
lawn tractor review	Living\Furnishing & Houseware	Living\Car & Garage			
lawncare	Living\Furnishing & Houseware	Living\Car & Garage			
laying ceramic tile	Living\Furnishing & Houseware				
lcd tv	Living\Furnishing & Houseware	Information\Science & Technology			
learn to speak japanese	Information\Education	Information\Arts & Humanities	Information\Local & Regional 		
learning carter style guitar	Information\Education	Entertainment\Music	Information\Arts & Humanities		
lee corso	Online Community\People Search	Information\Arts & Humanities			
library pictures	Information\Arts & Humanities	Information\Education			
lifespan of bulls	Living\Tools & Hardware	Living\Furnishing & Houseware	Information\Science & Technology		
limbitrol	Living\Health & Fitness	Information\Science & Technology			
lindenhurst; long island; new york	Information\Local & Regional 	Sports\Other			
list of state capitols	Information\Arts & Humanities	Information\Law & Politics	Information\Education	Information\Local & Regional 	
little giants	Entertainment\Movies				
little rock newspapers	Living\Book & Magazine	Information\Local & Regional 	Information\Law & Politics	Information\Arts & Humanities	
living room	Living\Furnishing & Houseware	Living\Real Estate			
long eared owl	Living\Pets & Animals	Information\Science & Technology			
longwood gardens	Living\Landscaping & Gardening				
lostlovers	Living\Dating & Relationships	Information\Arts & Humanities	Entertainment\Music		
lotto powerball	Entertainment\Games & Toys	Living\Finance & Investment			
louisiana state jobs	Living\Career & Jobs	Information\Local & Regional 			
lourdes water rosary	Living\Fashion & Apparel	Information\Companies & Industries	Information\Arts & Humanities	Information\Local & Regional 	
love and romance advice	Living\Dating & Relationships	Online Community\Forums & Groups	Information\Arts & Humanities		
lowes home inprovement	Shopping\Stores & Products	Information\Companies & Industries			
ltd purchases	Information\Companies & Industries	Shopping\Other			
lucas babin	Entertainment\Celebrities				
mac osx icons	Computers\Other				
major dad	Entertainment\TV	Living\Family & Kids			
malls in huntsville; tx	Shopping\Buying Guides & Researching	Information\Local & Regional 			
malone college	Information\Education	Information\Local & Regional 			
manheim	Living\Car & Garage	Entertainment\Celebrities	Online Community\Forums & Groups	Online Community\People Search	
map directions	Living\Travel & Vacation	Information\Local & Regional 			
maps florida	Living\Travel & Vacation	Information\Local & Regional 			
maps of india	Living\Travel & Vacation	Information\Local & Regional 			
marine corp rings	Living\Fashion & Apparel	Shopping\Stores & Products			
mario arcade games online	Entertainment\Games & Toys	Computers\Networks & Telecommunication			
mark scott	Online Community\People Search				
martha stewart paint colors	Living\Furnishing & Houseware	Shopping\Stores & Products	Entertainment\Celebrities		
massachusetts attorney	Information\Law & Politics	Information\Local & Regional 			
maui	Living\Travel & Vacation	Information\Local & Regional 			
max factor	Living\Fashion & Apparel	Information\Companies & Industries	Shopping\Stores & Products		
max payne mod	Entertainment\Games & Toys				
medieval astrology history	Information\Arts & Humanities	Information\Science & Technology	Information\Education		
mehendi designs	Information\Arts & Humanities				
melcor	Information\Companies & Industries	Computers\Hardware	Information\Science & Technology		
mens hairstyle	Living\Fashion & Apparel				
mens health	Living\Health & Fitness				
mens wedding rings	Living\Gifts & Collectables	Living\Fashion & Apparel			
mesabi daily news	Living\Book & Magazine	Information\Law & Politics	Information\Local & Regional 		
messenger express	Online Community\Chat & Instant Messaging	Computers\Networks & Telecommunication			
metal swing sets	Living\Furnishing & Houseware	Living\Family & Kids			
mi term life insurance quote	Living\Finance & Investment	Living\Health & Fitness	Information\Arts & Humanities		
micheals craft	Shopping\Stores & Products	Information\Arts & Humanities	Information\Companies & Industries		
microgramma font	Computers\Software	Information\Arts & Humanities	Information\References & Libraries		
micronet	Online Community\Homepages	Computers\Internet & Intranet	Information\Arts & Humanities	Information\Science & Technology	
microscope quiz	Information\Science & Technology	Information\Education			
microsoft forms	Information\Science & Technology	Information\Companies & Industries	Computers\Other		
migraine medications	Living\Health & Fitness	Information\Science & Technology			
mikasa-japan	Living\Food & Cooking	Living\Travel & Vacation	Information\Local & Regional 		
milk jug skeleton pattern	Living\Furnishing & Houseware	Living\Gifts & Collectables	Living\Fashion & Apparel	Information\Arts & Humanities	
millenium development goals	Information\Companies & Industries	Information\Arts & Humanities	Information\Local & Regional 		
minnesota offender locator	Information\Law & Politics	Information\Local & Regional 	Computers\Software		
miss match	Entertainment\TV	Living\Dating & Relationships			
mitsubishi	Living\Car & Garage	Information\Companies & Industries	Shopping\Stores & Products		
mix drink recipes	Living\Food & Cooking				
mls orlando	Living\Real Estate	Information\Local & Regional 			
mono vision	Shopping\Stores & Products	Information\Companies & Industries	Living\Health & Fitness		
mopar	Living\Car & Garage	Shopping\Stores & Products	Living\Book & Magazine		
motorhome magazine	Living\Book & Magazine	Living\Car & Garage			
mournful poems	Information\Arts & Humanities	Living\Dating & Relationships			
movie tshirts	Living\Fashion & Apparel	Entertainment\Movies			
movies listings	Entertainment\Movies	Shopping\Buying Guides & Researching			
msn best buy home page	Online Community\Homepages	Shopping\Buying Guides & Researching			
msn homepage	Online Community\Homepages				
msn messinger	Online Community\Chat & Instant Messaging	Online Community\Forums & Groups			
msnbc outlook	Online Community\Homepages	Online Community\Forums & Groups			
museum storage facility london	Information\Arts & Humanities	Information\Local & Regional 	Living\Travel & Vacation		
music to listen to	Entertainment\Music				
mydvd deluxe 5	Shopping\Stores & Products	Entertainment\Music	Computers\Hardware	Information\Science & Technology	
mystic river movie	Entertainment\Movies				
names of brittany spears family	Entertainment\Celebrities	Information\References & Libraries			
nancy lamott	Entertainment\Music	Entertainment\Celebrities			
nanny cams	Shopping\Stores & Products	Living\Tools & Hardware	Living\Family & Kids		
nara garden beach resort	Living\Travel & Vacation	Information\Local & Regional 			
natalie portman wallpaper	Computers\Other	Entertainment\Celebrities	Information\Arts & Humanities	Living\Fashion & Apparel	
national geographic traveler	Information\Local & Regional 	Information\Arts & Humanities	Living\Book & Magazine		
national health scholars	Living\Health & Fitness	Information\Science & Technology			
nba all star weekend tickets	Sports\Schedules & Tickets	Sports\Basketball			
nba draft mock	Sports\News & Scores	Sports\Basketball			
neon bar signs	Shopping\Stores & Products	Living\Furnishing & Houseware			
nervous system diagram	Information\Science & Technology				
new york bankruptcy courts	Information\Law & Politics	Information\Local & Regional 			
new york city bowling locations	Information\Local & Regional 	Entertainment\Other	Sports\Other		
new york clebrity clubs	Entertainment\Celebrities	Information\Local & Regional 			
new zealand clothes	Living\Fashion & Apparel	Information\Local & Regional 			
new zealand migration	Information\Law & Politics	Information\Local & Regional 			
newfoundland map	Information\Arts & Humanities	Information\Local & Regional 	Information\Science & Technology		
newspapers in tennessee	Living\Book & Magazine	Information\Local & Regional 			
nick cannon pics	Entertainment\Celebrities	Entertainment\Music			
nick jr	Computers\Internet & Intranet	Information\Education	Living\Family & Kids		
nightclubs in london	Living\Dating & Relationships	Information\Local & Regional 	Entertainment\Humor & Fun		
nj weddings	Living\Dating & Relationships	Living\Family & Kids	Living\Gifts & Collectables	Information\Local & Regional 	
no doc loans	Living\Finance & Investment				
nocheatersdate	Living\Dating & Relationships	Online Community\Forums & Groups			
nokia unlock	Information\Science & Technology	Computers\Mobile Computing	Information\Companies & Industries		
norcold	Shopping\Stores & Products	Living\Furnishing & Houseware	Information\Companies & Industries	Information\Science & Technology	
north carolina mountains	Information\Local & Regional 	Sports\Outdoor Recreations			
north county toyota	Living\Car & Garage	Information\Companies & Industries	Information\Local & Regional 		
nsw lotto	Entertainment\Games & Toys	Living\Finance & Investment	Information\Arts & Humanities		
nyjournalnews	Information\Arts & Humanities	Information\Local & Regional 			
oasis lyrics	Entertainment\Music	Online Community\Forums & Groups			
oink baby	Living\Fashion & Apparel	Living\Family & Kids			
oklahoma better business beura	Information\Local & Regional 	Information\Companies & Industries			
oklahomauniversity	Information\Education	Information\Local & Regional 			
one day at a time	Entertainment\Movies	Living\Dating & Relationships	Information\Arts & Humanities		
onslow county district court	Information\Law & Politics	Information\Local & Regional 			
oprah producers email	Entertainment\TV	Entertainment\Celebrities			
original movie posters	Entertainment\Movies	Entertainment\Pictures & Photos			
outsourcing and employment in us	Information\Companies & Industries	Living\Career & Jobs			
Panasonic Upright Vacuum	Living\Furnishing & Houseware	Living\Tools & Hardware	Information\Companies & Industries		
paris recipes	Living\Food & Cooking	Information\Local & Regional 			
parking at heathrow	Living\Travel & Vacation	Information\Local & Regional 			
parrot in the oven	Living\Book & Magazine	Information\Arts & Humanities			
parts source	Living\Car & Garage				
party entertainment	Living\Dating & Relationships	Entertainment\Humor & Fun	Entertainment\Other		
patrick roy pics	Entertainment\Celebrities	Sports\Hockey			
pay per click optimize	Information\Science & Technology				
pc roms	Entertainment\Games & Toys				
pcv valve	Living\Car & Garage	Shopping\Stores & Products			
pedal tractor parts	Living\Car & Garage				
pen friends in india	Living\Dating & Relationships	Online Community\Forums & Groups			
permenant abdominal gas remedies	Living\Health & Fitness	Information\Science & Technology			
permission slip	Information\Education	Living\Family & Kids	Information\Arts & Humanities		
personal page	Online Community\Homepages				
pex tubing prices	Living\Tools & Hardware	Living\Furnishing & Houseware	Shopping\Stores & Products	Shopping\Buying Guides & Researching	
pgatour	Sports\Schedules & Tickets	Sports\Outdoor Recreations			
philippians	Information\Arts & Humanities	Information\Local & Regional 			
photo radar	Living\Travel & Vacation	Information\Science & Technology	Living\Car & Garage		
pick up lines for guys	Living\Dating & Relationships	Entertainment\Humor & Fun			
pictures of hotrods	Living\Car & Garage	Entertainment\Pictures & Photos			
pictures of winter wonderland	Entertainment\Music	Living\Gifts & Collectables	Shopping\Stores & Products		
pictures siegfried roy	Entertainment\Celebrities	Entertainment\Games & Toys	Entertainment\Humor & Fun		
pilates workout	Living\Health & Fitness				
pinellas county clerk	Information\Law & Politics	Information\Local & Regional 			
ping irons	Sports\Outdoor Recreations	Shopping\Stores & Products	Information\Companies & Industries	Living\Health & Fitness	
pita bread recipes	Living\Food & Cooking				
platteville mining museum	Information\Local & Regional	Information\Arts & Humanities	Information\Companies & Industries	Information\References & Libraries	
playstation2 games	Entertainment\Games & Toys	Computers\Other			
pleasure of my company	Living\Book & Magazine	Information\Arts & Humanities			
plus size fashion	Living\Fashion & Apparel	Shopping\Stores & Products			
plus ultra	Information\Arts & Humanities	Information\Local & Regional 			
pocket watch	Shopping\Stores & Products	Living\Gifts & Collectables			
polaris trail blazer	Living\Car & Garage				
pontiac casting numbers	Living\Car & Garage				
popgames	Entertainment\Games & Toys				
portage county auditor	Information\Law & Politics	Information\Local & Regional 			
post-tetanic depression	Living\Health & Fitness	Information\Science & Technology			
prefontaine	Online Community\People Search	Sports\News & Scores			
preschool and halloween	Living\Family & Kids	Information\Education			
present condition of comanche tribe	Information\Law & Politics	Information\Local & Regional 			
president of russia	Information\Law & Politics	Information\Local & Regional 			
presnet-presbyterian medical group	Living\Religion & Belief	Living\Health & Fitness	Information\References & Libraries		
prince edward island	Living\Travel & Vacation	Information\Local & Regional 	Information\Education		
principal life	Living\Finance & Investment				
pro ana websites	Entertainment\Celebrities				
probability problems	Information\Science & Technology	Information\Education			
projectmanagement	Information\Arts & Humanities	Information\Education	Information\Science & Technology		
prometheus laboratories	Information\Companies & Industries	Information\Science & Technology	Living\Health & Fitness		
purpose of the national health service	Information\References & Libraries	Living\Health & Fitness	Information\Law & Politics		
qingqi	Living\Car & Garage				
quality paperback club	Information\Arts & Humanities	Living\Book & Magazine			
queens tudor realty	Living\Real Estate	Information\Local & Regional 			
qwest telephone book bellevue washington	Information\Local & Regional 	Living\Dating & Relationships			
qwestdex	Online Community\Forums & Groups	Computers\Networks & Telecommunication			
R.D. Call	Entertainment\Movies	Information\Arts & Humanities	Online Community\Forums & Groups		
radio control boats	Sports\Outdoor Recreations	Entertainment\Games & Toys	Shopping\Stores & Products	Living\Tools & Hardware	
radio shack in-dash speakers	Information\Companies & Industries	Living\Furnishing & Houseware	Living\Tools & Hardware		
rams head	Living\Food & Cooking	Information\Local & Regional 	Living\Travel & Vacation	Living\Real Estate	
rarity bay	Sports\Outdoor Recreations	Living\Dating & Relationships			
rdanderson	Entertainment\Celebrities	Entertainment\TV	Entertainment\Movies		
recipe crystal meth	Information\Law & Politics	Information\References & Libraries	Living\Health & Fitness		
recipe for german potatoe salad	Living\Food & Cooking				
red faction mods	Computers\Software	Computers\Multimedia	Entertainment\Games & Toys		
Red Sox Playoff Tickets	Sports\Schedules & Tickets	Sports\Baseball			
refinancing a home	Living\Finance & Investment	Living\Furnishing & Houseware	Living\Real Estate		
refurnished refridgeration displays	Living\Tools & Hardware	Shopping\Bargains & Discounts	Shopping\Stores & Products		
registerd nurse	Information\Science & Technology	Information\References & Libraries	Living\Health & Fitness		
relief society	Information\Law & Politics	Information\Local & Regional 	Online Community\Personal Services		
renassaince costumes	Living\Fashion & Apparel	Entertainment\Games & Toys			
reported speech	Information\Local & Regional 	Information\References & Libraries			
republican nixon	Information\Law & Politics	Information\References & Libraries			
retirementlink	Information\Local & Regional 	Living\Finance & Investment			
revivalsoy	Living\Health & Fitness	Living\Food & Cooking	Information\References & Libraries	Information\Companies & Industries	
roberts company	Living\Finance & Investment	Information\Education	Information\Companies & Industries		
rock crawler wheels	Living\Car & Garage	Shopping\Stores & Products			
rods western wear ohio	Information\Local & Regional 	Living\Fashion & Apparel	Shopping\Stores & Products		
rolex gmt master	Living\Fashion & Apparel	Living\Gifts & Collectables	Shopping\Stores & Products		
rolex wholesale	Shopping\Bargains & Discounts	Living\Gifts & Collectables	Living\Fashion & Apparel		
rollingstonemagazine	Living\Book & Magazine	Information\Arts & Humanities	Entertainment\Music		
roman empire christman	Information\Arts & Humanities	Information\Law & Politics	Information\References & Libraries	Living\Book & Magazine	
ronald and morgan and salisbury and maryland	Information\Local & Regional	Living\Travel & Vacation	Online Community\People Search 		
roof rack for 2005 mustang	Living\Tools & Hardware	Living\Car & Garage	Shopping\Stores & Products		
root canal	Living\Health & Fitness	Information\References & Libraries	Information\Science & Technology		
rosedale shopping center	Information\Local & Regional 	Shopping\Stores & Products			
rosenbluth	Living\Travel & Vacation	Shopping\Stores & Products			
rotisserie chicken recipe	Living\Food & Cooking				
roundworms in humans	Living\Health & Fitness	Information\References & Libraries	Living\Pets & Animals		
rules for working in south korea	Information\Law & Politics	Information\Local & Regional 	Living\Career & Jobs		
run time error visual basic 6	Computers\Software	Information\Science & Technology			
running clothes	Living\Health & Fitness	Living\Fashion & Apparel	Shopping\Stores & Products	Shopping\Buying Guides & Researching	
rv rentals	Shopping\Lease & Rent	Sports\Outdoor Recreations	Shopping\Stores & Products		
safety technology	Computers\Security	Information\Science & Technology	Information\Law & Politics	Information\Companies & Industries	
saks fifth avenue	Living\Fashion & Apparel	Shopping\Stores & Products	Living\Gifts & Collectables		
sally hansen	Living\Fashion & Apparel	Living\Gifts & Collectables	Shopping\Stores & Products	Shopping\Buying Guides & Researching	
sample lesson plan	Information\Education	Information\References & Libraries	Computers\Other		
san francisco giants tickets	Sports\Schedules & Tickets	Sports\Baseball			
santa fe new mexico	Information\Local & Regional 	Living\Travel & Vacation	Information\References & Libraries	Living\Real Estate	
santa rosa apartments	Shopping\Lease & Rent	Living\Real Estate	Information\Local & Regional 		
scandinavian food	Living\Food & Cooking	Shopping\Stores & Products	Shopping\Buying Guides & Researching	Information\Local & Regional 	
scenes from basic instinct	Entertainment\Movies	Entertainment\Pictures & Photos	Entertainment\Celebrities		
schooldude	Computers\Software	Information\Education	Shopping\Stores & Products		
scientific names for leaves	Information\Science & Technology	Information\References & Libraries			
scott & todd in the morning	Entertainment\Radio				
seememe refresh windows registry -serial -keygen -crack	Computers\Security	Computers\Software	Information\Science & Technology	Information\Companies & Industries	
self-storage units	Shopping\Lease & Rent	Living\Furnishing & Houseware	Shopping\Stores & Products		
serenity prayer alanon	Living\Religion & Belief				
sesame seeds	Information\References & Libraries	Living\Food & Cooking	Living\Health & Fitness	Shopping\Stores & Products	
shanghai frangance	Living\Gifts & Collectables	Shopping\Stores & Products			
sharereactor	Online Community\Forums & Groups	Computers\Software	Information\Law & Politics		
shawnee tribe	Information\Arts & Humanities	Information\References & Libraries	Information\Local & Regional 		
sheraton hotel	Living\Travel & Vacation	Shopping\Stores & Products			
sheridan paintball	Sports\Other	Entertainment\Games & Toys	Shopping\Stores & Products	Shopping\Buying Guides & Researching	
shimla	Living\Travel & Vacation	Information\Local & Regional 	Information\References & Libraries	Information\Arts & Humanities	
SHIRI	Information\Law & Politics	Information\Local & Regional 			
siefred and roy	Entertainment\Celebrities	Entertainment\Other	Living\Travel & Vacation	Shopping\Stores & Products	
sierra madre oriental	Living\Travel & Vacation	Information\Local & Regional 	Information\References & Libraries		
signs of depression	Living\Health & Fitness	Information\References & Libraries			
silk clothing	Living\Fashion & Apparel	Shopping\Stores & Products			
silver necklace	Living\Gifts & Collectables	Shopping\Stores & Products	Shopping\Buying Guides & Researching		
skull makeup	Entertainment\Humor & Fun	Shopping\Stores & Products			
smart and ripper	Computers\Software	Entertainment\Movies	Shopping\Buying Guides & Researching		
smartmoney	Living\Finance & Investment	Information\Companies & Industries	Shopping\Buying Guides & Researching		
smirnoff	Living\Food & Cooking	Entertainment\Other			
snap-on tools in west virginia	Living\Tools & Hardware	Shopping\Stores & Products			
snowflake pattern	Information\Science & Technology	Information\Education			
social security disability	Information\Law & Politics	Living\Health & Fitness	Living\Finance & Investment		
sociology jobs	Living\Career & Jobs	Information\Law & Politics	Information\References & Libraries		
sony and canada	Information\Companies & Industries	Information\Local & Regional 	Shopping\Stores & Products	Entertainment\Other	
sony audio equipment	Entertainment\Music	Shopping\Stores & Products	Living\Furnishing & Houseware		
south dakota public radio	Information\Local & Regional 	Entertainment\Radio	Information\References & Libraries		
south park mexican pictures	Information\Local & Regional 	Entertainment\Pictures & Photos	Living\Travel & Vacation		
southeast airlines	Information\Companies & Industries	Living\Travel & Vacation	Shopping\Stores & Products		
southwest airlins	Information\Companies & Industries	Living\Travel & Vacation	Shopping\Stores & Products		
spanish courses in jaca	Information\Education	Information\Local & Regional 	Living\Career & Jobs	Shopping\Other	
spathic	Information\Companies & Industries				
special pals	Online Community\Homepages	Living\Pets & Animals			
spiderman web blaster	Entertainment\Games & Toys	Shopping\Stores & Products			
spiegel ultimate outlet	Living\Fashion & Apparel	Living\Furnishing & Houseware	Shopping\Stores & Products		
spooky halloween stuff	Entertainment\Humor & Fun	Shopping\Stores & Products			
sportaid	Information\Companies & Industries	Living\Furnishing & Houseware	Shopping\Stores & Products	Sports\Other	Living\Health & Fitness
sportcourtgolf.com	Sports\Other	Online Community\Homepages			
sports license plate	Living\Car & Garage	Sports\Other	Living\Tools & Hardware		
sprint rollover minute	Information\Companies & Industries	Computers\Mobile Computing	Shopping\Stores & Products		
sprintz	Living\Furnishing & Houseware	Information\Companies & Industries	Shopping\Stores & Products		
spy cam	Computers\Networks & Telecommunication	Living\Furnishing & Houseware	Living\Tools & Hardware		
stanford university	Information\Education	Information\References & Libraries	Online Community\Homepages		
star magazine	Living\Book & Magazine	Entertainment\Celebrities			
star registry	Living\Gifts & Collectables	Information\Companies & Industries	Online Community\Homepages		
starting my rap career	Living\Career & Jobs	Entertainment\Music	Information\Arts & Humanities		
sterling custom cabinetry pa	Living\Furnishing & Houseware	Living\Tools & Hardware	Shopping\Stores & Products		
steve newman" books	Living\Book & Magazine				
stock futures	Living\Finance & Investment	Information\References & Libraries	Information\Companies & Industries		
street wars	Computers\Multimedia	Computers\Software	Entertainment\Games & Toys		
striper fishing	Sports\Outdoor Recreations	Living\Tools & Hardware			
strong funds	Living\Finance & Investment	Information\Companies & Industries	Information\References & Libraries		
studioeonline.com	Shopping\Lease & Rent	Online Community\Homepages			
sun glasses	Living\Fashion & Apparel	Living\Health & Fitness	Shopping\Stores & Products		
super saiyan brolly	Entertainment\Humor & Fun	Entertainment\Games & Toys			
supercars	Living\Car & Garage	Online Community\Homepages	Shopping\Stores & Products		
supercheats	Computers\Multimedia	Entertainment\Games & Toys	Online Community\Forums & Groups		
superman emblem	Entertainment\Games & Toys	Living\Gifts & Collectables	Entertainment\Movies		
superstitions	Information\References & Libraries				
surfing posters	Sports\Outdoor Recreations	Shopping\Stores & Products			
susquehanna county	Information\Local & Regional 	Information\References & Libraries			
symantec removal tool	Computers\Security	Computers\Software	Living\Tools & Hardware		
systray	Computers\Software				
tama	Information\Local & Regional 	Living\Tools & Hardware	Living\Fashion & Apparel		
tankinis	Living\Fashion & Apparel	Shopping\Stores & Products			
tatoos	Entertainment\Humor & Fun	Living\Other			
taylor corporation	Information\Companies & Industries				
tectonic plates	Information\Science & Technology	Information\References & Libraries			
tenchu	Computers\Multimedia	Entertainment\Games & Toys			
terri schaivo	Information\Law & Politics	Living\Religion & Belief	Living\Health & Fitness		
texas wildflowers	Living\Landscaping & Gardening	Information\References & Libraries			
tgi fridays	Living\Food & Cooking	Information\Local & Regional 			
the lincoln journal star	Living\Book & Magazine	Information\Local & Regional 			
the media	Computers\Internet & Intranet	Information\Arts & Humanities			
the wb	Entertainment\Movies	Entertainment\Games & Toys	Entertainment\TV		
themed evenings	Entertainment\Humor & Fun	Entertainment\Games & Toys			
themes of dracula (1931)	Entertainment\Movies	Information\Arts & Humanities			
thrombolytic therapy for thrombosis of aortic prosthesis	Living\Health & Fitness	Information\References & Libraries			
thunder tiger	Entertainment\Games & Toys	Living\Gifts & Collectables			
timberland loafers women	Living\Fashion & Apparel	Shopping\Stores & Products			
tips on tornatos	Information\References & Libraries	Living\Other			
tj maxx	Living\Fashion & Apparel	Information\Companies & Industries	Shopping\Stores & Products		
todays interest rates	Living\Finance & Investment				
toilet bowl	Living\Furnishing & Houseware	Shopping\Stores & Products			
tom clancy	Living\Book & Magazine	Information\Arts & Humanities	Online Community\People Search		
toroidal transformer	Living\Tools & Hardware	Shopping\Stores & Products			
toshiba projector carrying case	Computers\Hardware	Computers\Multimedia	Living\Furnishing & Houseware	Shopping\Stores & Products	Shopping\Buying Guides & Researching
toy boomerang	Entertainment\Games & Toys	Shopping\Stores & Products			
toyota of el cajon	Living\Car & Garage	Shopping\Stores & Products			
trail running shoes	Living\Fashion & Apparel	Living\Health & Fitness	Shopping\Stores & Products	Shopping\Buying Guides & Researching	Sports\Other
travel hotels	Living\Travel & Vacation				
travelzoo	Living\Travel & Vacation	Online Community\Homepages			
tritronic electronic training dog collars	Living\Pets & Animals	Information\Companies & Industries	Shopping\Stores & Products		
tumeric	Living\Food & Cooking	Computers\Other			
turntables	Living\Furnishing & Houseware	Shopping\Stores & Products			
tv1 cable tv	Entertainment\TV	Information\Companies & Industries			
tweetybird pictures	Entertainment\Pictures & Photos	Living\Pets & Animals			
Tweeze Epil	Living\Tools & Hardware	Shopping\Stores & Products			
twisted colon	Living\Health & Fitness	Information\Science & Technology			
uconn football tickets	Sports\American Football	Sports\Schedules & Tickets			
ugly man	Living\Dating & Relationships				
uk telephone directory	Information\Local & Regional 	Online Community\People Search			
ultimate fitness	Living\Health & Fitness	Information\References & Libraries			
under construction gifs	Computers\Software	Entertainment\Pictures & Photos			
unix web hosting provider	Computers\Internet & Intranet	Information\Companies & Industries			
upland bird country	Information\Local & Regional 	Sports\Outdoor Recreations	Living\Travel & Vacation		
us free classifieds	Information\Local & Regional 	Online Community\Personal Services	Shopping\Buying Guides & Researching	Shopping\Bargains & Discounts	Shopping\Stores & Products
usa lottery	Information\Law & Politics	Living\Other	Information\Arts & Humanities		
used chopper motorcycles	Living\Car & Garage	Shopping\Bargains & Discounts			
used pianos pittsburgh; pa	Shopping\Bargains & Discounts	Shopping\Stores & Products	Shopping\Other		
used tuxedos	Living\Fashion & Apparel	Shopping\Bargains & Discounts	Shopping\Stores & Products	Shopping\Buying Guides & Researching	Shopping\Auctions & Bids
ustanorcal	Sports\Tennis				
vanity stool	Living\Furnishing & Houseware	Shopping\Stores & Products			
ventura mls	Living\Real Estate				
venus ruler of taurus	Living\Dating & Relationships	Information\References & Libraries			
viagra dosage	Living\Health & Fitness	Living\Dating & Relationships			
victoria high school	Information\Local & Regional 	Information\References & Libraries			
viking memory	Computers\Hardware				
virtus online	Computers\Software	Computers\Internet & Intranet	Information\Education		
voltage drop	Information\Science & Technology	Living\Career & Jobs			
vote ontario	Information\Law & Politics	Information\Local & Regional 			
wade pottery	Living\Gifts & Collectables	Living\Furnishing & Houseware			
waldensians	Living\Religion & Belief	Information\Law & Politics	Information\References & Libraries		
Walk in Coolers	Living\Furnishing & Houseware	Shopping\Other			
washington and jefferson	Information\Law & Politics	Information\Arts & Humanities	Information\References & Libraries		
watersofteners	Living\Food & Cooking	Shopping\Stores & Products			
waynesville nc	Information\Local & Regional 	Living\Travel & Vacation			
web shots	Computers\Internet & Intranet	Entertainment\Pictures & Photos	Computers\Software	Computers\Hardware	Information\References & Libraries
wedding food	Living\Food & Cooking	Living\Family & Kids	Living\Other	Shopping\Stores & Products	
wedding invitions	Living\Family & Kids	Living\Gifts & Collectables	Shopping\Stores & Products	Shopping\Buying Guides & Researching	
wedding shower invitations	Living\Family & Kids	Living\Gifts & Collectables	Shopping\Stores & Products	Shopping\Buying Guides & Researching	
wedgewood golf course	Information\Local & Regional 	Sports\Outdoor Recreations	Sports\Other	Information\Other	
weight training tips	Living\Health & Fitness	Sports\Other	Information\References & Libraries		
what is scandisk?	Computers\Software	Computers\Security			
wheaties premium giveaways	Shopping\Auctions & Bids	Shopping\Other			
where to login to john carroll university email	Online Community\Forums & Groups	Computers\Internet & Intranet	Information\Local & Regional Information\Education		
wholesale office furniture	Shopping\Bargains & Discounts	Living\Furnishing & Houseware	Shopping\Buying Guides & Researching	Shopping\Stores & Products	Shopping\Buying Guides & Researching
wi athletic association	Information\Local & Regional	Sports\Other	Living\Health & Fitness 		
wild hog hunting	Entertainment\Other	Information\References & Libraries	Living\Pets & Animals	Sports\Outdoor Recreations	
Will Ferrell	Entertainment\TV	Entertainment\Humor & Fun	Information\Law & Politics		
william-sonoma.com	Living\Food & Cooking	Living\Furnishing & Houseware	Shopping\Stores & Products	Living\Gifts & Collectables	Living\Landscaping & Gardening
wills helen newington	Sports\Tennis	Information\References & Libraries			
winchester amunition	Sports\Other	Entertainment\Other	Information\Law & Politics		
windows xp blinds	Computers\Software	Computers\Security	Computers\Other		
windvd	Computers\Software	Computers\Multimedia	Entertainment\Movies		
wine and cheese baskets	Living\Food & Cooking	Living\Furnishing & Houseware	Entertainment\Other	Living\Gifts & Collectables	Shopping\Stores & Products
winona ryder photos	Entertainment\Pictures & Photos	Entertainment\Celebrities	Entertainment\Movies		
womens suffrage in the 1920s	Information\Law & Politics	Information\References & Libraries			
wood workers	Living\Career & Jobs	Information\Companies & Industries			
words to song for you by kenny latimore	Entertainment\Music				
worker and characteristics	Information\Companies & Industries	Information\Other			
workout clothing	Living\Fashion & Apparel	Living\Health & Fitness	Shopping\Stores & Products	Shopping\Buying Guides & Researching	Sports\Other
world atlas	Information\References & Libraries	Information\Local & Regional 	Living\Book & Magazine	Living\Travel & Vacation	
world gold council	Living\Finance & Investment	Living\Gifts & Collectables	Information\Science & Technology	Information\References & Libraries	Information\Companies & Industries
wrist watch	Living\Fashion & Apparel	Living\Furnishing & Houseware	Shopping\Stores & Products	Shopping\Buying Guides & Researching	
writing an authorisation manual	Information\Arts & Humanities	Information\References & Libraries	Information\Education	Computers\Software	
writs of assistance	Information\Law & Politics	Information\References & Libraries	Information\Education	Living\Book & Magazine	
www irs com	Information\Law & Politics	Information\Local & Regional 	Information\Arts & Humanities		
www.jcpenneys	Shopping\Stores & Products	Information\Local & Regional 	Shopping\Bargains & Discounts		
yamaha musical instruments	Entertainment\Music	Shopping\Stores & Products	Living\Furnishing & Houseware	Living\Other	
yoga photos	Living\Health & Fitness	Entertainment\Pictures & Photos	Information\Arts & Humanities	Information\References & Libraries	Living\Religion & Belief
youngs figurine	Living\Gifts & Collectables	Shopping\Stores & Products	Shopping\Buying Guides & Researching		
zeromancer	Entertainment\Music	Entertainment\Celebrities	Entertainment\Pictures & Photos		
zoo disny	Entertainment\Pictures & Photos	Living\Family & Kids	Living\Travel & Vacation	Shopping\Stores & Products	
